XXXXXXXXXXXXXXXXX
X...............X
X...............X
X...............X
X...............X
X...............X
X...............X
X...............X
X.......G.......X
X...............X
X...............X
X...............X
X...............X
X...............X
X...............X
X...............X
XXXXXXXXXXXXXXXXX


